R 640 480
NO ./path_to_the_north_texture
SO ./path_to_the_south_texture
WE ./path_to_the_west_texture
EA ./path_to_the_east_texture

S ./path_to_the_sprite_texture
C 220,100,2
F 225,30,12

11111111111111
11001101010011
10000000000001
10000000000001
1100000N000011
10000000000001
10000000000001
10000011100001
11111111111111
