R 640 0
NO ./textures/Candy_Cane_Green.xpm
SO ./textures/Candy_Cane_Red.xpm
WE ./textures/Ice_Brick_Wall.xpm
EA ./textures/Snow_Brick_Wall.xpm

S ./textures/ChestRed.xpm
C 175,238,238
F 160,82,45

11111111
10011001
10020201
110000011
100000001
1100N0011
10002011
11111111
1012101
1012101
1012101
1012101
1012101
1111111
