

SO        ./textures/Candy_Cane_Red.xpm

NO     ./textures/Candy_Cane_Green.xpm

WE     ./textures/Ice_Brick_Wall.xpm

C      175,     238      ,     238
R          640         480

F 160       ,     82    ,45

EA ./textures/Snow_Brick_Wall.xpm

S ./textures/ChestRed.xpm

    11111  111111
    10001  100201
  111002111100001
  1111100100N0001
11100000000000001
12000000000010001
1000000W020000001
10200W00000000001
10000002000000001
10000011111100001
1000001    100001
100E001    100001
1100101    111E01
1000001    100001
1011111    100001
1000001    100001
1100001    100001
1111111    111111
